000000000000000000000000000000000000000000000
000000000000000000000000000000000000000000000
000000000000000000000000000000000000000000000
000000000000000000000000000000001110000000000
000000000000000000000000000000000000000000000
000000000000000000000000000000000000000000000
000011100000000000000000000000000000000000000
000000000000000000000000000000000000000000000
000000000000000000001110000000000000000000000
000000000000000000001111110000000000000000000
000000000000000000001111110000000011100000000
000000000000000000001110000000000000000000000
000000000000000000000000000000000000000000000
000000000000000000000000000000000000000000000
000000000000000000000000000000000000000000000
000000000000000000000000000000000000000000000
000000000000000000000000000000000000000000000
000000000000000000000000000000001110000000000
000000000000000000000000000000000000000000000
000000000000000000000000000000000000000000000
000011100000000000000000000000000000000000000
000000000000000000000000000000000000000000000
111111111100000000000000111111111111111111111
