001101011101101110001110
000000000000101110001110
101110001110101110001110
101100010110101110001110
101110111011101110000000
101101011101101101010001
000000000000101110001110
101110001110000000001110
101100010110000000001110
101110111011000000011101
101110111011101110001110
101101011101101101011101
000000000000101110001110
101110001110101110001110
101100010110101110001110
101110111011101110001110