222222222222222222222222222222222222222222222
111111111111111111111111111111111111111111111
111111111111111111111111111111111111111111111
111111111112222222111111111111111111111111111
111111111111111111111111111111111111111111111
111111111111111111111111111111111111111111111
111111111111111111111111111111111111211111111
111111111111111111111111111111111111211111111
111111112111111100000000000011111111211111111
111111112111111100000000000011111111211111111
111111112111111100001110000011111111211111111
111111112111111100001110000011111111211111111
111111111111111100000000000011111111111111111
111111111111111100000000000011111111111111111
111111111111111111111111111111111111111111111
111111111111111111111111111111111111111111111
111111111111111111111111111111111111111111111
111111111111111111111111111111111111111111111
111111111111111111111111111111111111111111111
111111111222221111111111111111111111111111111
111111111111111111111111111112222222211111111
111111111111111111111111111111111111111111111
222222222222222222222222222222222222222222222
